111111111111111111111
100000000C000C0000001
1000000C0000000000001
10000000000000C000001
100000000000000100001
1000E0011111111100001
100000C00000000100001
100000000000000100001
10000C00000P000100001
100000000000000000001
111111111111111111111
