11111111111111111111111111111111111111111111111111
1E0000000000000CCC000000000000000000000000000000P1
10000000000000000C00000000000000000000000000000001
11111111111111111111111111111111111111111111111111