11111111111111111111
10000000000000000001
11100000000000000001
1C100000000000000001
1C100000000000000001
1C100000000000000001
1CC10000000000000001
1CC1000000P000000001
10000000000000000001
11111111111111111111