111111111111111111111
111111111111111111111
110000000000000000011
111100000000000000011
11C100000000000000011
11C100000000000000011
11C100000000000000011
11CC10000000000000011
11CC1000000P000000011
110000000000000000011
111111111111111111111
111111111111111111111