11111111111111111111111111111111111111111
100000000C000C000000000000000000000000001
1000000C000000000000000000000000000000001
10000000000000C00000000000000000000000001
10000000000000000000000000000000000000001
1E111111111111100000000000000000000000001
100000C0000010100000000000000000000000001
1000000P000000C00000000000000000000000001
10000C00000111100000000000000000000000001
100000000C000C000000000000000000000000001
1000000C000000000000000000000000000000001
10000000000000C00000000000000000000000001
10000000000000000000000000000000000000001
11111111111111000000000000000000001000001
100000C000001010000CCCCCCCCCCCCCCCCCCCC01
1000000C000000C00CCCCCCCCCCCCCCCCCCCC0001
10000C0000011110000CCCCCCCCCCCCCCCCCCCC01
11111111111111111111111111111111111111111