1111111111111111111111111111111111111111
100000000C000C00000000000000000000000001
1000000C00000000000000000000000000000001
10000000000000C0000000000000000000000001
1000000000000000000000000000000000000001
1E11111111111110000000000000000000000001
100000C000001010000000000000000000000001
1000000P000000C0000000000000000000000001
10000C0000011110000000000000000000000001
100000000C000C00000000000000000000000001
1000000C00000000000000000000000000000001
10000000000000C0000000000000000000000001
1000000000000000000000000000000000000001
1111111111111100000000000000000000100001
100000C000001010000CCCCCCCCCCCCCCCCCCCC1
1000000C000000C00CCCCCCCCCCCCCCCCCCCC001
10000C0000011110000CCCCCCCCCCCCCCCCCCCC1
1111111111111111111111111111111111111111