1111111111111111111
1EC00000000000001P1
1111111111111111111