11111111111111111111111111111111111111111111111111111111111111111111111111111111111111
100000000C000C0000000000000000000000000000000000000000000000011CCCC10000000000000000C1
1010000C0000000000000000000000000000000000000000000000000000011C11C11000000000000000C1
10100000000000C000000000000000000000000000000000000000000000011C11C10000000000000000C1
101000000000000100000000000000111111111111111C11111111111111111C11C10000000000000000C1
1EC11111111111CCCC011111111111111111111111111CCCCCCCCCCCCCCCCCCCC1C11000000000000000C1
11C11111111111C1111111111111111111111111111111111111111111111111C1C11111111111111111C1
100000C000001001000000000000000000000000000000000CCCCCCC00000111C1C11000000000000000C1
1000000000001C0100000000CC000C000000000000000000000000000000011CC1C11100000000000000C1
10000C0000001111000000000000000000000CCCC000000000000000000001CC11C11000000000000000C1
10000000000000000000000000000000000000000000000000000000000001C111C10000000000000000C1
11111111111111111111111111CCCCCCCC111111111111111111111111111CC111C10000000000000000C1
100000000C000C000000000000000000000000000000000000000000000001C111C10000000000000000C1
1010000C000000000000000000000000000000000000000000000000000001CC11C10000000000000000C1
10100000000000C00000000000000000000000000000000000000111111111C111C10000000000000000C1
101000000000000100000000000000111111111111111C1111111111CCCCCCC111C11000000000000000C1
10111111111111CCCC01P111111111111111111111111C111111111CC11111CCC1C10000000000000000C1
100000C000001001000000000000000000000000000000000CCCCCCC00000111CC000C10000000000000C1
1000000000001C0100000000CC000C0000000000000000000000000000000000001C1C10000000000000C1
10000C00000C1111000000000000000000000CCCC00000000000000000000000111C1C10000000000000C1
1000000000000000000000000000000000000000000000000000000000000000CCCC1CCC100000000000C1
1000000000000000000000000000000000000000000000000000000000000000CCCC1CCC100000000000C1
1000000000000000000000000000000000000000000000000000000000000000CCCC1CCC100000000000C1
1000000000000000000000000000000000000000000000000000000000000000CCCC1CCC100000000000C1
1000000000000000000000000000000000000000000000000000000000000000CCCC1CCC100000000000C1
11111111111111111111111111111111111111111111111111111111111111111111111111111111111111