111111111111111111111111111111111111111111111111111111111111111111111111111111111111111111111111111
100000000000000000000000000000000000000000000000000000000000000000000000000000000000000000000000001
1000000000000000000000000000000000CCCCCCCCCCCCCCCCCCCCCCCCCCCCCCCCCCCCCCCCCCCCCCCCCCC00000000000001
1000000000000000000000000000000000CCCCCCCCCCCCCCCCCCCCCCCCCCCCCCCCCCCCCCCCCCCCCCCCCCC00000000000001
1000000000000000000000000000000000CCCCCCCCCCCCCCCCCCCCCCCCCCCCCCCCCCCCCCCCCCCCCCCCCCC00000000000001
1000000000000000000000000000000000CCCCCCCCCCCCCCCCCCCCCCCCCCCCCCCCCCCCCCCCCCCCCCCCCCC00000000000001
100000000000000000000000000000000000000000000000000000000000000000000000000000000000000000000000001
100000000000000000000000000000000000000000000000000000000000000000000000000000000000000000000000001
100000000000000000000000000000000000000000000000000000000000000000000000000000000000000000000000001
100000000000000000000000000000000000000000000000000000000000000000000000000000000000000000000000001
100000000000000000000000000000000E00000000000000000000000000000000000000000000000000000000000000001
10000000000000000000000000000000000000000000000000000CCCCCCCCCCCCCCCCCCCCCCCCCCCCCCCCCC000000000001
10000000000000000000000000000000000000000000000000000CCCCCCCCCCCCCCCCCCCCCCCCCCCCCCCCCC000000000001
10000000000000000000000000000000000000000000000000000CCCCCCCCCCCCCCCCCCCCCCCCCCCCCCCCCC000000000001
10000000000000000000000000000000000000000000000000000CCCCCCCCCCCCCCCCCCCCCCCCCCCCCCCCCC000000000001
10000000000000000000000000000000000000000000000000000CCCCCCCCCCCCCCCCCCCCCCCCCCCCCCCCCC000000000001
100000000000000000000000000000000000000000000000000000000000000000000000000000000000000000000000001
100000000000000000000000000000000000000000000000000000000000000000000000000000000000000000000000001
10000000000000000000000000000000000000000000000000000000000000000P000000000000000000000000000000001
1000000000000000000000000000000000000000000000000000000000000000CCCCCCCCCCCCCCCCCCCCCCCCCCCCCCCCCC1
1000000000000000000000000000000000000000000000000000000000000000CCCCCCCCCCCCCCCCCCCCCCCCCCCCCCCCCC1
1000000000000000000000000000000000000000000000000000000000000000CCCCCCCCCCCCCCCCCCCCCCCCCCCCCCCCCC1
111111111111111111111111111111111111111111111111111111111111111111111111111111111111111111111111111