1111111111111111111111111111111111111111111111111111111111111111111111111111111111
1E000000000000000000CCCCCCCCCCCCCCCCCCCCCCCCCCCCCC000000000000000000000000000000P1
10000000000000000000CCCCCCCCCCCCCCCCCCCCCCCCCCCCCC00000000000000000000000000000001
1111111111111111111111111111111111111111111111111111111111111111111111111111111111