1111111111111111111
1000000000000000001
1110000000000000001
1C10000000000000001
1C10000000000000001
1C10000000000000001
1CC1000000000000001
1CC1000000P00000001
1000000000000000001
1111111111111111111
