11111111111111111111111111111111
10000000000000000000000000000001
10000000000000000000000000000001
1000000000000000P000000000000001
10000000000000000000000000000001
10000000000000000000000000000001
10000000000000011111111111111111
10000000000000012222222222222221
10000000000000012222222222222221
10000000000000012222222222222221
10000000000000012222222222222221
10000000000000012222222222222221
10000000000000012222222222222221
10000000000000012222222222222221
11111111111111111111111111111111